XXXXXXXXXXXXXXXXXXXXXXXXXXXXXXXXXXXXXXXXXXXXXXXXXXXXXXXXXXXXXXXXXXXXXXXXXXXXXXXXXXXXXXXXXXXXXXXXXXXXXXXXXXXXXXXXXXXXXXXXXXXXXXXXXXXXXXXXXXXXXXXXXXXXXXXXXXXXXXXXXXXXXXXXXXXXXXXXXXXXXXXXXXXXXXXXXXXXXXXXX
X                             X               X           X X     X                       X                   X                                                           X                             X
X XXXXX XXXXXXXXX XXX XXXXXXX X XXXXX XXXXXXX X   XXXXX XXX XXX XXX XXXXXXX XXXXXXXXX XXX X XXXXXXX XXX XXXXX X XXXXXXX XXX   X XXXXXXX XXXXXXXXX XXX XXXXXXXXXXX XXXXXXXXX XXXXXXX XXXXXXX XXXXXXX XXX X
X X   X X       X   X X     X X X   X X X     X   X     X     X X X       X X       X X X X X       X X X   X   X     X X X   X       X           X   X         X X X       X     X X   X X X     X   X X
X X X XXX X XXXXX XXXXX X XXX X XXX XXX XXXXXXX XXX X XXX XXX X X X XXXXXXX XXX XXXXX X X XXX XXXXXXX X X   XXXXX XXX X X X XXX XXXXXXX XXXXX XXX XXX XXXXXXXXX X X XXX XXXXX   XXX XXX X XXX XXXXX XXX X
X X X     X X     X     X X   X   X             X   X X   X X   X X X         X X       X   X X       X X       X X   X   X X   X     X X   X X               X X X   X X       X     X       X         X
X XXX XXX X X   XXX XXX X X   XXX XXX XXX XXX XXX XXX X XXX XXX X X X XXXXX X X XXXXXXXXX XXX XXXXXXX X XXX XXX XXX XXX XXX X X XXXXX X X XXX XXXXX XXXXX XXXXX X X   X X XXX   X XXX XXXXXXX XXX XXXXX X
X   X X X X X   X   X X X X     X     X X X X X   X   X X   X X X X X     X X X               X     X X   X         X X X   X X     X   X X       X     X X       X   X X X X   X X X           X X   X X
X X X X XXX XXXXX XXX X XXX     X X XXX XXX X X XXX   X X XXX X X X XXXXX X X XXX XXXXX XXXXX X XXXXX XXXXX XXXXXXXXX X X   XXX XXX XXX X XXXXX XXX XXXXX X XXXXXXX XXX X X X   XXX X XXXXXXX XXX XXX XXX
X X X X   X       X   X         X X X       X X X     X X       X X   X X X X     X   X     X   X         X X           X     X X X   X X X   X X X X     X X       X   X X X       X X     X   X   X   X
X X XXXXX XXX XXX X X X XXXXXXXXX XXX XXXXX X X X XXX X X XXX XXX XXXXX X X X XXX XXX XXX X XXX X X XXXXX X XXXXXXXXXXX XXXXX XXX XXX XXX XXX XXX XXX XXX XXX XXXXX XXX X X XXXXX XXX XXX X XXX X X XXX X
X X           X X X X X X           X X   X X X X X X X X X X X         X X X X X   X   X X   X X X X     X       X   X     X   X   X           X X     X         X     X       X X     X X   X X X   X X
X XXX XXXXX XXX X X XXX X XXXXXXX XXX XXX X XXX X X X X XXX X X XXXXXXX X XXX X XXX XXX X X   X XXX X XXX X   XXX XXX XXXXX X X X XXX XXX XXXXX X XXX XXX XXX     XXXXX XXXXX XXXXX     XXX XXX X X   X X
X X X       X   X       X X     X X     X X     X X X       X X       X       X   X   X       X     X   X X     X   X     X X   X X   X X X   X     X X X X X         X     X                 X X     X X
X X XXX XXX X X XXXXX X XXX XXX X XXX XXX X XXX X X X XXXXX X XXX XXX XXX XXXXX XXX   X XXXXXXXXX XXX XXX XXX XXX XXXXXXX XXX X X X XXX XXX X X XXX X X X X X XXXXXXX X XXX XXX XXX XXX XXX XXX XXXXXXX X
X X   X X X X X     X X     X       X X   X X X X   X X   X X   X X     X X     X     X X       X X   X     X           X     X X X X       X X X   X X X X X X   X   X X X X X     X X X   X         X X
X X X XXX X X X X XXX X XXXXX   XXXXX X XXX X X X XXX XXX X XXXXX XXXXXXX XXXXX X XXXXX XXXXXXX X X   X XXX XXXXXXX XXX XXX XXX X X XXX XXXXXXX XXXXX X X X XXX X X XXX X XXX XXXXXXX X XXXXXXXXXXX XXX X
X X X     X X X X X     X X     X     X X X X X X X       X     X               X X             X X   X X         X X X   X     X X X X X             X X X     X X X   X       X     X     X     X X   X
X X X XXX X XXX X XXX XXX XXX XXX XXXXX X XXX X X XXX X XXX XXX XXXXX   XXX XXXXX X XXX XXXXXXXXX XXX X XXXXXXXXX X X XXX XXXXXXX X X X XXXXXXXXXXX X X X XXXXXXX X X XXX XXXXXXX XXX XXX XXX     X XXX X
X X X X X X     X   X X     X X   X           X X   X X X     X   X X   X X X     X X X X           X X   X     X X X   X         X X             X X X           X X X           X X   X X       X     X
X XXX X X X XXX XXXXX X X X X XXXXX XXXXX XXXXX X XXX X X XXX XXXXX X XXX X X XXXXX X X XXX X X XXXXX X   X XXX X X XXX XXXXXXX XXX X XXXXX XXX XXX XXX XXX     XXX X XXXXX   XXXXX XXX X X XXX XXX XXX X
X   X X X X X X         X X X           X X       X   X X X X       X X             X X   X X X       X   X X   X X   X       X       X     X   X     X X X     X   X     X   X         X X X X X   X X X
X X X X X X X X XXXXXXX XXX XXXXXXX   XXX X   XXX XXXXX XXX XXXXXXX XXX XXXXX XXX X X X XXX XXX XXXXXXXXX X XXXXX X XXXXXXXXX X XXX   X X XXX XXXXX XXX X X XXXXX   XXXXX X   XXXXXXXXXXX XXX X XXXXX X X
X X X X   X X X       X X         X   X   X   X X                 X     X   X X X       X X X   X       X X       X X         X   X   X X X   X     X   X X X           X X                           X X
X X X XXXXX X XXXXXXX XXX XXX XXX X XXX   XXX X XXXXXXXXX XXX XXXXX XXXXX X XXX X XXX XXX X X   X XXXXX X XXX X XXX X X XXXXXXX XXX XXX X X XXXXXXX X X X X X XXXXX XXX X XXXXXXXXX XXXXX XXX XXXXXXXXX X
X X X       X       X   X     X X   X     X X X         X X X X X   X     X     X X X       X   X     X X     X X   X X X       X   X   X X X     X X X X X X X   X X X X   X       X   X X X X         X
X X XXXXX   XXXXXXX XXX XXX XXX XXXXX XXXXX X XXXXXXXXX X X X X X   X XXX X XXX X X XXX XXXXX XXX XXX X XXX XXX XXXXX XXX XXXXX X XXX XXX XXX XXX X X XXX X X X XXXXX X X XXX X XXXXX XXX X X XXXXX XXXXX
X X     X         X   X   X X               X         X X     X X   X   X   X X X X   X X     X     X X     X             X   X X   X X         X X X   X X X X X     X X X   X X   X X   X X   X   X   X
X XXXXX XXX XXXXXXX XXX X X X XXX XXXXX XXX X XXX     X X XXX X XXX XXX XXX X X X X XXX X XXX XXXXX XXX XXX XXX XXXXXXX X XXX X XXXXXXX XXXXXXXXX XXX XXX X X X X XXXXX X X X X X XXX XXX X XXX XXX X X X
X         X   X     X   X X X   X X   X X X X X X     X   X X     X   X   X X X X       X X X     X     X     X       X X   X           X       X     X     X X X       X X X X   X     X X   X   X X   X
X X XXX XXX XXX XXXXX XXX X X XXX X   X X X X X XXX XXX XXX XXX X XXX X XXX X X XXXXXXX X X XXXXX X XXX XXX   XXXXXXX XXXXXXX XXXXXXXXX XXXXXXX X XXXXX X XXX X XXXXX X XXX XXX XXX XXX X XXX XXXXX XXX X
X X X X X   X   X     X   X X X   X   X X X X X   X X         X X   X X X   X X       X X X     X X X X   X         X     X   X       X       X X X     X X         X X         X   X X X   X         X X
X X X XXX XXX X XXX XXX XXX X X X XXX XXX X XXX X X XXXXX XXXXX X   X XXX XXX X XXX XXX X XXX XXX X X XXXXX     XXX X XXXXX   XXXXXXX XXX XXX X X X   XXX XXXXX XXXXX XXX XXXXX XXXXX X XXX XXXXXXXXXXX X
X X X         X     X       X X X   X     X     X X     X X     X   X     X   X   X X       X X   X X           X   X X         X   X   X   X X   X   X       X         X     X       X X               X
X X X XXX XXX XXXXX XXXXXXX XXX XXX X XXXXX X XXX XXX X XXX XXX X XXXXXXX XXX X XXX XXXXXXX X XXX X XXXXX XXX   XXX XXX XXXXX X XXX XXX X XXX XXXXX   XXX XXX X XXX     XXX X X XXXXXXX XXXXX XXX XXXXX X
X X   X X X X     X       X       X X       X       X       X X X X     X     X X X       X X   X X     X         X   X     X X   X X X X               X X   X X X       X X   X           X X X X   X X
X X XXX X X XXXXX XXXXXXXXX XXXXX X XXXXX XXXXX     XXXXXXXXX X XXX XXXXX XXX X X XXXXX   XXX   XXX XXX XXX XXXXX X XXX XXXXX XXX X X X XXX XXXXX XXX X X XXX X X X XXX XXX X XXX XXXXX X X X X X XXX X X
X X X X X X X   X         X     X X     X                   X       X     X   X X     X             X X   X X   X X     X       X X X X   X       X X   X   X X X   X X       X       X X X X   X   X X X
X XXX X X X XXX XXXXXXXXX X XXXXX XXXXX XXX XXX XXXXX XXX X XXXXXXX XXX X XXXXX X XXXXX       XXXXX X X   X X XXX XXXXX X XXXXXXXXX X X X XXXXXXX X X XXXXXXX X XXXXX XXX XXX X   XXXXX X X XXX X XXX X X
X X   X   X             X   X   X     X   X     X   X X   X   X   X   X X       X X           X   X X X     X           X X         X X X       X   X X       X         X   X X   X   X X     X X X   X X
X XXX XXX XXX XXX XXXXX XXX XXX X XXXXX XXX XXX XXX X XXXXX   XXX X XXX XXX XXXXX X XXX     XXX XXXXX XXXXX XXXXX XXX XXX XXX XXX X X XXX XXXXXXXXX X XXXXXXX XXX XXXXXXX XXX X XXX XXX XXX   XXX X X X X
X   X       X X X X   X   X     X X     X   X X   X X           X   X     X X     X   X     X       X           X   X X     X X X X X         X   X X       X   X X         X X X   X     X       X X X X
X   XXXXX XXX X XXX X X XXX     XXX XXX XXXXX XXX X X XXX XXXXX XXXXX XXXXX X XXX XXX XXXXX X XXX   X XXXXXXXXX X XXX X XXX XXX X XXX XXX XXXXX XXX XXX XXXXX XXX X X XXX XXX X XXX X XXX XXXXXXXXX XXX X
X       X X X       X X X           X X         X X X X X X         X       X X X   X     X X X X   X   X     X X     X X       X     X X X     X       X     X   X X X X X   X   X X   X               X
X XXX XXX X XXX XXXXX X XXX   XXX XXX XXXXXXX X X X XXX X XXX XXXXX XXXXXXX XXX X X XXXXX X X X X   XXXXXXXXX XXXXX XXX XXXXXXXXX XXXXX X X XXX X XXX XXX XXX XXXXX X X X XXXXX XXX XXX XXXXXXXXXXXXX X X
X X   X   X   X X X X X   X   X   X         X X X       X X X     X       X     X X     X X X X X                 X X             X     X X X X X X X X   X X       X X X       X     X   X         X X X
X X X X XXX XXX X X XXX XXX XXXXX X XXXXX XXX X X XXXXX XXX XXXXX X   XXX X XXXXX XXX XXX XXX X X     XXXXXXX XXX X XXX XXXXXXX XXXXXXX XXXXX X XXX XXX XXX X XXX X X X XXX XXX XXX X X   XXXXXXXXX XXX X
X X X X X   X     X   X X   X   X X X   X X   X X X   X         X X   X X   X       X X     X   X     X     X   X X   X X     X X         X             X   X X   X X X     X X   X X X           X   X X
X XXX X X XXX XXXXX X XXX XXX X X X XXX X X XXX X X X XXX   XXX XXX XXX XXXXX XXX XXX X XXX XXX X XXXXX XXXXX XXX XXX X X XXX X X XXXXXXX XXXXXXXXXXXXX X XXX XXX X X XXXXXXX XXX X X XXXXX   XXX X X X X
X     X X X   X           X   X X X   X X X   X X X X   X     X     X         X X X   X   X   X X X     X     X     X X X X X X X X     X             X   X   X X X         X X   X       X   X X X X X X
X XXX X X X XXX XXX XXX XXX XXX X X X X XXX XXX XXX X XXX XXXXXXXXX XXX XXXXX X XXX XXX XXXXX X X X XXX XXX XXX XXX XXX X X XXX X XXX XXX XXXXXXX     X XXX XXX X X XXXXXXXXX XXXXX XXX XXX XXX X XXX X X
X X X X   X X   X X X X X   X   X X X X   X X       X X   X       X   X       X     X   X     X X X X X   X X   X X     X X     X   X X         X     X X       X X X               X   X X X   X     X X
X X X XXX X X XXX XXX X XXX XXX X X X XXX XXX X XXXXX XXX X X     X   XXXXXXX X   XXXXX XXXXXXX X X X XXXXX X XXX XXX XXX XXX XXX X X X XXXXXXX XXXXX XXX   XXX XXX XXX XXX XXX     X XXX X XXX X XXX X X
X X     X   X X       X     X X X X X   X     X X       X   X     X         X     X   X X       X X X   X   X         X     X X   X X   X     X             X X       X X X X X     X X   X   X X X X X X
X X XXX XXXXX X XXXXX X   XXX X XXX XXX XXXXX X XXXXX X XXX XXXXX X XXXXXXX X XXXXX X XXX XXX XXX X X X X X XXX XXXXX XXXXX XXX XXX XXX X XXX XXXXXXXXXXXXX X XXX XXX X X XXX XXX XXX X XXX X X XXX XXX X
X X   X       X   X X X   X       X   X X   X X     X     X     X   X     X X       X       X     X X X X X   X X   X     X X   X     X X X X   X         X X   X X   X X       X X   X X   X X     X   X
X XXX XXXXXXX XXXXX X X X XXXXXXX X XXX XXX X XXX XXX XXXXX XXX XXXXX   XXX XXXXX X XXXXX XXX XXX X X X XXX   XXX X X XXX X XXXXX XXX X XXX XXX XXX XXXXXXX XXX X XXX XXX XXXXXXX XXXXX XXXXX XXXXX X   X
X           X         X X       X         X X   X X   X     X X         X X     X       X X       X X X           X   X X X       X X X     X X   X X         X     X     X                       X X   X
X XXXXX XXX X XXX XXXXX XXX XXX XXX XXXXXXX X XXX X   XXXXXXX X X XXXXXXX XXX   XXX   XXX X XXX XXX X XXX         XXX X X X X XXX X X X X XXX X XXX XXXXXXXXX X XXX X     XXX XXX XXX XXXXXXX   XXX XXX X
X X X   X X X   X X         X X   X         X X   X           X X X         X     X   X   X X X X   X   X           X X   X X X       X   X   X X           X   X X X       X   X X X X     X   X     X X
X X X XXX X X XXX XXX X XXXXX XXX XXXXXXXXXXX XXXXX XXX XXXXX X X X XXX XXX X XXX XXXXX X XXX XXX XXX   X     XXXXX X XXXXX XXX XXXXX XXXXX XXX X XXXXXXX X X XXX X XXXXX X XXX X X XXX XXX XXXXX XXXXX X
X X   X     X X     X X X       X             X     X X X     X X X X X   X X X         X X       X           X   X X X   X     X   X           X X     X X X X   X     X X   X   X     X X       X     X
X XXX XXXXX X X X XXX X X XXXXX XXX XXXXX X XXX XXX X X XXXXX X X X X XXX X X X XXX XXX XXX       XXXXXXX XXX XXX XXX XXX XXXXX X   X XXXXX XXXXX X XXXXX X XXX XXX XXX XXX XXX XXX X XXX X XXXXXXX XXX X
X   X     X X X X     X X     X   X     X X X     X X       X X X X X   X X X X X X X X                 X X X   X       X     X X   X X   X X     X X     X X       X X     X X X   X X   X X     X     X
X XXX XXX XXX X XXX XXX XXX XXX   X XXXXX X XXXXX XXX XXXXX X X X X XXX XXX X X X XXX XXXXX XXX XXXXX X X X XXX X XXXXX X XXX X X XXXXX XXX XXX X X XXX XXX X XXXXX X XXXXXXX X XXX X XXX X XXX XXX XXX X
X X     X     X   X X     X       X X     X     X     X     X X   X   X     X X X         X X X X   X X X X   X X X   X X X X X     X   X     X X X   X       X   X X         X   X X   X       X   X X X
X XXXXX XXX XXX X X XXXXX X XXXXXXX X XXXXX XXX XXX   XXXXX X XXX X XXX XXX XXX XXXXXXXXX X X X XXX X X X XXX XXX X XXX X X X XXX XXX   XXXXXXX X XXX XXXXXXXXX X X X   XXXXX XXXXX XXX X XXXXXXX X X X X
X     X   X X   X X     X X X         X     X X   X       X X   X X X                 X X X       X X X X   X     X X     X     X               X   X           X X X   X   X         X X         X X X X
X XXX X XXX XXXXXXX X XXX X X XXX   XXX XXXXX XXX X   XXX XXX   X XXX   XXXXXXX XXX XXX X X XXXXX X XXX XXX XXX XXX XXXXXXXXXXX XXX XXXXXXX XXXXX XXX X XXX XXX XXX X XXX XXX XXXXXXX X XXXXX XXXXX X X X
X X   X X   X       X X     X   X   X   X       X X   X X       X X     X     X   X X     X X   X X X     X     X     X       X   X X     X X X   X   X X   X X       X   X         X       X X     X X X
X XXX X XXX XXXXXXX X XXXXXXX XXX XXXXXXX XXXXX X XXXXX X     XXX X     X XXX XXX XXX XXX X X   XXX XXXXXXX XXX XXX XXX XXXXXXX X XXX XXX X X X XXX X X XXXXX XXXXXXX XXX XXXXXXXXX XXXXX XXXXX XXXXX X X
X   X X   X       X X         X   X   X   X X X X       X         X     X   X   X   X   X X X               X X   X X   X   X   X     X X X X X X   X X X           X   X         X X   X X   X X     X X
X XXX XXX X XXXXX XXXXXXX XXX X XXX XXX XXX X XXX XXXXXXX XXX X XXX XXX X XXX XXX XXX XXX X XXX XXXXXXXXXXXXX XXXXX XXX X X X X X XXXXX X XXX X XXX XXXXX XXX XXXXX XXX XXXXX X XXX X XXX XXX X X XXXXX X
X X     X   X           X X X X X   X                   X X X X X   X X X X   X   X   X   X   X X           X           X X X X X X     X     X   X         X X   X   X X   X X X X   X     X X X       X
X XXXXX XXX X   XXX X XXX X XXX X XXX X XXXXX X XXXXXXXXX X XXX X XXX X XXX   X X XXX XXX XXXXX X XXX XXX XXX XXX XXXXX X XXX X X XXX XXX XXXXX X XXXXX   XXX XXX X X XXX XXX XXX XXXXX XXXXX X XXXXX XXX
X     X   X X   X X       X     X     X X   X X           X     X X   X       X X   X   X         X X   X X     X   X   X     X X   X X   X     X X X X   X   X X X X     X             X           X X X
X XXX X XXX X XXX X XXXXX XXX XXXXX XXXXX XXX XXX XXX   X XXXXXXX X XXX XXX XXX X   X X XXX     XXX X X X X XXX XXXXX XXX XXX XXX XXX XXX XXXXXXX X X XXXXX XXX X X XXXXXXX XXXXXXXXX X XXXXXXXXXXXXX X X
X X X X     X X   X     X   X     X X     X   X   X X   X X         X   X X X   X   X X   X     X     X X   X X       X   X X     X           X   X X     X X   X X     X     X     X X               X X
X X X XXX XXXXXXX XXXXX XXX XXX XXX X XXX XXX XXXXX XXX X XXXXXXX XXX XXX X X XXX   X X   XXX   XXXXX X XXX X X XXXXX X XXX XXXXX X XXXXX XXX X XXX X XXXXX XXX X XXX XXX XXXXX XXXXXXX XXXXX X XXXXX X X
X       X       X   X X       X X   X X X X X         X           X   X     X X     X X     X       X X   X   X     X X     X   X X X   X     X X   X X       X X   X X   X     X       X   X X X   X X X
X XXXXX XXX XXXXX X X X X XXX XXXXX X X X X XXXXXXX X XXX XXXXXXXXX XXXXX XXX XXXXX X X XXX X XXX XXX XXXXX XXX XXX X X XXXXX X X X X   XXXXXXX X XXX XXXXXXXXX X   X X XXX     XXX   XXX XXX X X   X X X
X X   X   X X     X X   X X X     X X X X X       X X X X X             X X         X     X X X X X     X   X   X X X X X     X X   X             X             X   X X X         X   X   X   X X   X   X
X X XXX X X XXX XXX XXX X X X XXX X XXX X XXX   XXX X X X X XXXXXXXXXXX XXX XXXXXXX XXXXXXX X X XXX XXX X XXX   X X X XXX   XXX X XXX XXXXX X XXX XXX XXXXX XXX X XXX X XXXXXXX X X   X   XXX XXX   XXX X
X X X   X X   X       X X   X X X       X   X   X   X X X X X             X X     X         X X   X   X X X     X   X           X X   X   X   X X   X     X X X   X           X X X         X         X X
X X XXXXX XXX XXX XXX X X XXX X X XXXXX X XXX   X XXX X XXX X XXX XXX XXX XXX XXX XXX XXX XXX XXX X XXX X XXX   X   X XXX XXX XXX X XXX XXX XXX XXX XXX XXX X XXX X X XXXXX XXX X X         XXXXXXXXX X X
X   X   X       X X   X X X     X X     X X X   X X   X     X X X X X X       X X   X   X X X   X X X   X   X   X   X X X X X X   X   X X   X     X   X     X   X X X X     X   X X                 X X X
X XXX XXXXX XXXXX XXX X XXX XXX X XXX XXX X XXX XXXXX X XXXXX X X X XXXXXXX XXX XXX X XXX X XXX X X X XXX XXX XXX   XXX XXX XXX XXX XXX XXX XXX XXX X XXXXX X XXX X X X XXXXX XXX X   XXXXXXXXX     X X X
X X       X X       X X         X   X X       X     X X X       X X       X         X X   X   X X X X X   X   X     X       X   X   X     X     X   X     X X X   X X X X       X X   X       X     X X X
X X XXX   X XXX XXX XXX XXXXXXX XXXXX X X XXX XXX XXX X X XXXXX X X XXXXXXX     XXX X XXXXX X X X X X X   XXX XXX XXX   XXXXX X X XXX XXX XXX XXX   X     X X X XXX X X X XXXXXXX XXX XXXXX X X XXX X X X
X X X X   X   X X X     X     X       X X   X X X X   X X   X   X X X           X X X         X X X X X     X     X     X     X X X   X X   X X     X     X X   X   X   X X     X   X     X X X X X X X X
XXX X X X X X XXX XXX XXX XXXXXXX XXX X XXXXX X X X   X XXXXX X X X XXXXXXX XXX X X XXX XXXXX X X X X XXX X X XXXXX     X XXXXX XXX XXX X X X XXXXX X XXXXX XXX XXXXX   X X XXX X X XXX X XXX X X XXX X X
X   X X X X X       X X   X     X X X X   X   X X X   X       X X         X X X X X   X X   X X X   X   X X X X         X     X         X X       X           X X       X X X X X X   X X X   X X     X X
X XXX X X X XXX XXX XXX   X XXX XXX XXX X XXXXX X XXX XXX XXXXX X XXXXXXX XXX XXX XXX X X XXX X XXX XXX XXXXX X XXX XXXXXXXXXXX XXXXXXX X XXXXXXX XXXXXXX XXX X X XXX   X XXX X XXX X X X XXX XXX XXXXX X
X X   X X   X X X         X X X X       X           X   X X       X     X           X X X X   X   X   X         X X X           X     X X       X       X X   X X   X   X     X     X X X X X     X     X
X X XXX X XXX X X XXXXX XXX X X XXXXXXX X XXXXX XXX X XXX XXX XXXXX XXX XXXXXXXXXXX X X X XXX XXX XXXXXXX XXXXXXX X X X XXXXXXX X XXX XXX XXXXX X XXX XXX XXXXX XXX XXX XXX XXX XXX XXX X X XXXXXXX XXX X
X X     X X   X X X     X   X       X   X   X X X X X X       X     X             X X   X   X             X       X X X X     X X X           X X X X X           X X     X X   X X   X X X   X       X X
X X XXXXX XXX X XXXXX XXX XXX XXXXX XXX X XXX X X X X X XXX XXX XXX XXX XXX XXXXX X XXX X XXX X XXXXX XXX X XXX X XXX X X X XXX XXX XXXXX XXX XXX X X XXXXXXXXX XXX X XXXXX X XXX XXX X X X XXXXXXX XXX X
X X X       X X     X X   X   X       X X X   X X   X X X X X   X X   X X X X     X   X   X   X X     X X X X X       X X X         X X   X X X   X           X X   X     X X X     X X X X         X X X
X XXX XXXXXXX XXXXX X XXXXX   XXXXXXXXX XXX XXX XXXXX XXX XXX XXX XXX XXX XXXXXXXXX X XXXXXXXXX XXXXXXX XXXXX XXXXXXXXX XXX XXXXXXXXX XXXXX XXX   XXXXXXXXXXXXX XXX XXXXXXX XXX XXX XXX XXX XXXXXXXXX X X
X                                                             X                                                                                               X                 X           X           X
XXXXXXXXXXXXXXXXXXXXXXXXXXXXXXXXXXXXXXXXXXXXXXXXXXXXXXXXXXXXXXXXXXXXXXXXXXXXXXXXXXXXXXXXXXXXXXXXXXXXXXXXXXXXXXXXXXXXXXXXXXXXXXXXXXXXXXXXXXXXXXXXXXXXXXXXXXXXXXXXXXXXXXXXXXXXXXXXXXXXXXXXXXXXXXXXXXXXXXXXX
